NO       esse/caminho/vai/ser/lidado/pela/mlx
           SO         caminho/invalido
WE /caminho/errado
EA /errado

C     255,255,255
F 42,84,168

        1111111111111111111111111
        1000000000100000000000001
        1011000001110000000000001
        1001000000000000000000001
111111111011000001110000000000001
100000000011000001110111111111111
11110111111111011100000010001
11110111  1111011101010010011
11000000110101011100000010001
10000000000000001100000010001
10000000000000001101010010001
11000000110101011111011110N0011
11110111 1110101 101111010001
11111111 1111111 111111111111

        1111111111111111111111111
        1000000000100000000000001
        1011000001110000000000001
        1001000000000000000000001
111111111111111111111111111111111
